10 10 10 10 10 10 10 10 10 10 10 10 10 10 10 10 10 10 10 10 43 44 57 58 57 42 43 252 252 252 252 252 252 252 252 252 252 252 252 252 252 252 252 252 252 252 252 252 252 252 252 252 252 252
10 10 10 10 10 10 10 10 10 10 10 10 10 10 10 10 10 10 10 10 46 47 57 58 57 45 46 252 252 252 252 252 252 252 252 252 252 252 252 252 252 252 252 252 252 252 252 252 252 252 252 252 252 252
10 10 10 10 10 10 10 10 10 10 10 10 10 10 10 10 10 10 10 10 46 47 57 58 57 45 46 252 252 200 201 201 201 201 201 201 201 201 201 201 201 201 201 201 201 201 201 201 201 201 202 252 252 252
10 10 10 10 10 10 10 10 10 10 10 10 10 10 10 10 10 10 10 10 46 47 57 58 57 45 46 252 252 203 204 204 204 204 204 204 204 204 204 204 204 204 204 204 204 204 204 204 204 204 205 202 252 252
10 10 10 150 152 152 152 152 152 152 152 152 152 152 152 152 151 10 10 10 46 47 57 58 57 45 46 252 252 203 204 204 204 204 204 204 204 204 204 204 204 204 204 204 204 204 204 204 204 204 205 205 252 252
10 10 10 153 154 329 154 154 154 154 154 154 154 154 154 154 159 10 10 10 46 47 57 58 57 45 46 252 252 203 204 204 204 204 204 339 207 207 207 207 207 207 207 207 340 204 204 204 204 204 205 205 252 252
10 10 10 156 158 158 158 158 158 158 158 158 158 158 158 158 157 10 10 10 46 47 57 58 57 45 46 252 252 203 204 204 204 204 204 205 241 241 241 241 241 241 241 241 203 204 204 204 204 204 205 205 252 252
10 10 10 129 130 130 130 130 130 130 130 130 130 130 130 130 131 10 10 10 46 57 57 58 57 45 46 252 252 203 204 204 204 204 204 205 247 275 247 247 247 247 275 247 203 204 204 204 204 204 205 208 252 252
10 10 10 132 133 327 133 327 133 133 133 133 327 133 327 133 134 10 10 10 125 57 57 58 57 45 46 252 252 206 207 207 207 207 207 208 247 276 247 247 247 247 276 247 206 207 207 207 207 207 208 242 252 252
10 10 10 129 130 130 130 130 130 130 130 130 130 130 130 130 131 10 10 10 46 59 57 58 57 45 46 252 252 240 241 241 241 241 241 242 247 276 247 247 247 247 276 247 240 241 241 241 241 241 242 248 252 252
10 10 10 129 130 130 130 130 130 130 130 130 130 130 130 130 131 10 10 10 125 57 57 58 57 45 46 252 252 246 247 247 247 247 247 248 247 276 247 247 247 247 276 247 246 247 247 247 247 247 248 341 252 252
10 10 10 129 130 130 130 130 130 130 130 130 130 130 130 130 131 10 10 10 46 57 57 58 57 45 46 252 252 330 331 331 331 331 331 331 331 331 332 330 332 330 331 331 331 331 331 331 331 331 332 252 252 252
10 10 10 129 130 130 130 130 130 130 130 130 130 130 130 130 131 10 10 10 46 47 57 58 57 45 46 252 252 334 335 335 335 335 335 336 334 335 336 337 338 334 335 336 335 335 335 335 335 335 336 252 252 252
10 10 10 135 136 136 136 136 136 328 136 136 136 136 136 136 137 10 10 10 46 47 57 58 57 45 46 46 46 95 342 95 95 95 95 95 95 95 95 95 95 95 95 95 95 95 95 95 95 95 95 46 46 47
45 46 46 46 46 46 46 46 46 95 46 46 46 46 46 46 46 46 46 46 46 47 57 58 57 45 46 46 46 46 46 46 46 46 46 46 46 302 46 95 95 46 300 46 46 46 46 46 46 46 46 46 46 47
51 126 52 52 52 52 52 52 52 96 52 52 52 52 52 52 52 52 52 52 52 53 57 58 57 51 52 52 52 52 52 52 52 52 52 52 52 301 52 96 96 52 299 52 52 52 52 52 52 52 52 52 52 53
57 57 57 57 57 57 57 57 57 57 57 57 57 57 57 57 57 57 57 57 94 57 57 57 57 57 57 57 57 57 57 57 57 57 57 57 57 57 57 57 57 57 57 57 57 57 57 57 57 57 57 57 57 57
93 93 93 93 93 93 93 93 93 93 93 93 93 93 93 93 93 93 93 57 94 93 93 93 93 93 93 93 93 93 93 93 93 93 93 93 93 93 93 93 93 93 93 93 93 93 93 93 93 93 93 93 93 93
57 57 57 57 57 57 57 57 57 57 57 57 57 57 57 57 57 57 57 57 94 57 57 57 57 57 57 57 57 57 57 57 57 57 57 57 57 57 57 57 57 57 57 57 57 57 57 57 57 57 57 57 57 57
42 43 43 127 43 43 43 43 43 43 43 43 43 43 43 43 43 43 43 43 43 43 43 57 43 43 43 43 43 43 44 57 57 57 42 43 43 43 43 43 43 43 43 43 43 43 43 43 43 43 43 43 43 44
45 46 46 46 46 46 46 46 46 46 46 46 46 46 46 46 46 46 46 46 46 46 46 57 46 46 46 46 46 46 47 90 90 90 45 46 46 46 46 46 46 46 46 46 46 46 46 46 46 46 46 46 46 47
10 41 10 41 10 41 10 41 10 41 10 41 10 41 10 41 10 41 10 41 10 41 10 10 10 41 10 41 10 46 47 57 57 57 45 46 252 252 252 252 252 252 252 252 252 200 201 201 201 201 201 202 252 252
41 10 41 10 41 10 41 10 41 10 138 140 140 140 140 140 140 140 140 140 139 10 41 10 41 10 41 10 41 46 47 57 91 57 45 46 211 211 211 219 211 211 211 219 252 203 204 204 204 204 204 205 252 252
10 41 10 41 10 41 10 41 10 41 141 142 142 142 142 142 142 142 142 142 147 41 10 41 10 41 10 41 10 46 47 57 92 57 45 46 214 214 214 214 214 214 214 215 252 203 204 204 256 204 204 205 252 252
41 10 41 10 41 10 41 10 41 10 141 278 142 142 142 142 148 142 148 142 147 10 97 99 99 99 99 99 99 46 47 57 58 57 45 46 214 257 214 214 214 214 214 215 253 203 204 204 204 204 204 205 252 252
10 41 10 41 10 41 10 41 10 41 141 142 142 142 142 142 142 142 142 142 147 41 100 101 277 101 101 101 101 46 47 57 58 57 45 46 214 214 214 214 214 214 214 215 252 206 207 207 207 207 207 208 255 252
60 62 60 62 62 62 62 62 61 10 141 142 142 142 142 142 142 142 142 142 147 10 103 105 105 105 105 105 105 46 47 57 58 57 45 46 217 217 217 219 217 217 217 219 252 224 225 225 225 225 225 226 252 252
63 64 63 64 64 64 64 86 69 41 144 146 146 146 146 146 146 146 146 146 145 41 110 111 111 111 111 111 111 46 47 57 58 57 45 46 241 241 241 236 241 241 241 236 252 230 231 231 231 231 231 232 255 252
66 68 66 68 68 68 68 68 67 10 268 274 269 274 269 274 269 274 269 274 270 10 110 111 111 111 111 111 111 46 47 57 58 57 45 46 247 247 247 237 247 247 247 237 254 227 228 228 259 228 228 229 252 252
72 73 72 73 73 73 73 73 74 41 268 274 269 274 269 274 269 274 269 274 270 41 110 111 111 111 111 111 111 52 53 57 58 57 51 52 247 247 247 237 247 247 247 237 252 230 231 231 231 231 231 232 255 252