10 10 10 10 10 10 10 10 10 10 10 10 10 10 10 10 10 10 10 10 10 10 10 10 10 10 10 10 10 10 10 10 10 10 10 10 10 10 10 10 10 10 10 10 10 10 10 10 10 10 10 10 10 10
10 10 10 10 10 10 10 10 10 10 10 10 10 10 10 10 10 10 10 10 10 10 10 10 10 10 10 10 10 10 10 10 10 10 10 10 10 10 10 10 10 10 10 10 10 10 10 10 10 10 10 10 10 10
10 10 10 10 10 10 10 10 10 10 442 445 445 445 445 445 445 445 445 445 445 445 445 445 446 10 10 10 10 10 10 10 10 10 10 10 10 10 10 10 10 10 10 10 10 10 10 10 10 10 10 10 10 10
10 10 10 10 10 10 10 10 10 10 443 448 453 453 453 453 453 453 453 453 453 453 453 450 443 10 10 10 10 10 10 10 10 10 10 10 10 10 10 10 10 10 10 10 10 10 10 10 10 10 10 10 10 10
10 10 10 10 10 10 10 10 10 10 443 451 453 453 453 453 453 453 453 453 453 453 453 453 443 10 10 10 10 10 10 10 10 10 10 10 10 10 10 10 10 10 10 10 10 10 10 10 10 10 10 10 10 10
10 10 10 10 10 10 10 10 10 10 443 451 453 453 453 453 453 453 453 453 453 453 453 453 443 10 10 10 10 10 10 10 442 445 445 445 445 445 445 445 445 445 445 445 446 10 10 10 10 10 10 10 10 10
10 10 10 10 10 10 10 10 10 10 443 451 453 453 453 453 453 453 453 453 453 453 453 453 443 10 10 10 10 10 10 10 443 454 454 454 454 454 454 454 454 454 454 454 443 10 10 10 10 10 10 10 10 10
10 10 10 10 10 10 10 10 10 10 443 451 453 453 453 453 453 453 453 453 453 453 453 453 443 10 10 10 10 10 10 10 443 454 454 454 454 457 454 454 454 454 454 454 443 10 10 10 10 10 10 10 10 10
10 10 10 10 10 10 10 10 10 10 443 451 453 453 453 453 453 453 453 453 453 453 453 453 443 10 10 10 10 10 10 10 443 454 454 454 454 458 454 454 455 456 454 454 443 10 10 10 10 10 10 10 10 10
10 10 10 10 10 10 10 10 10 10 443 451 453 453 453 453 453 453 453 453 453 453 453 453 443 10 10 10 10 10 10 10 443 453 453 453 453 453 453 453 453 453 453 453 443 10 10 10 10 10 10 10 10 10
10 10 10 10 10 10 10 10 10 10 443 451 453 453 453 453 453 453 453 453 453 453 453 453 443 10 10 10 10 10 10 10 443 459 453 453 453 453 453 453 453 453 453 460 443 10 10 10 10 10 10 10 10 10
10 10 10 10 10 10 10 10 10 10 443 451 453 453 453 453 453 453 453 453 453 453 453 453 443 10 10 10 10 10 10 10 443 453 453 453 453 453 453 453 453 453 453 453 443 10 10 10 10 10 10 10 10 10
10 10 10 10 10 10 10 10 10 10 443 451 453 453 453 453 453 453 453 453 453 453 453 453 444 445 445 445 445 445 445 445 447 453 453 453 453 453 453 453 453 453 453 453 443 10 10 10 10 10 10 10 10 10
10 10 10 10 10 10 10 10 10 10 443 451 453 453 453 453 453 453 453 453 453 453 453 453 454 454 454 454 454 454 454 454 454 453 453 453 453 470 470 470 470 470 453 453 443 10 10 10 10 10 10 10 10 10
10 10 10 10 10 10 10 10 10 10 443 451 453 453 453 453 453 453 453 453 453 453 453 453 454 462 454 463 454 464 454 465 454 453 453 453 453 466 467 467 467 468 453 453 443 10 10 10 10 10 10 10 10 10
10 10 10 10 10 10 10 10 10 10 443 451 453 453 453 453 453 453 453 453 453 453 453 453 454 454 454 454 454 454 454 454 454 453 453 453 453 469 469 469 469 469 453 453 443 10 10 10 10 10 10 10 10 10
10 10 10 10 10 10 10 10 10 10 443 451 453 453 453 453 453 453 453 453 453 453 453 453 453 453 453 453 453 453 453 453 453 453 453 453 453 453 453 453 453 453 453 453 443 10 10 10 10 10 10 10 10 10
10 10 10 10 10 10 10 10 10 10 443 451 453 453 453 453 453 453 453 453 453 453 453 453 453 453 453 453 453 453 453 453 453 453 453 453 453 453 453 453 453 453 453 453 443 10 10 10 10 10 10 10 10 10
10 10 10 10 10 10 10 10 10 10 443 451 453 453 453 453 453 453 453 453 453 453 453 453 453 453 453 453 453 453 453 453 453 453 453 453 453 453 453 453 453 453 453 453 443 10 10 10 10 10 10 10 10 10
10 10 10 10 10 10 10 10 10 10 443 451 453 453 453 453 453 453 453 453 453 453 453 453 453 453 453 453 453 453 453 453 453 453 453 453 453 453 453 453 453 453 453 453 443 10 10 10 10 10 10 10 10 10
10 10 10 10 10 10 10 10 10 10 443 451 453 453 453 453 453 453 453 453 453 453 453 453 453 453 453 453 453 453 453 453 453 453 453 453 453 442 445 445 445 445 445 445 447 10 10 10 10 10 10 10 10 10
10 10 10 10 10 10 10 10 10 10 443 473 453 453 453 453 453 453 453 453 453 453 453 453 453 453 453 453 453 453 453 453 453 453 453 453 453 443 10 10 10 10 10 10 10 10 10 10 10 10 10 10 10 10
10 10 10 10 10 10 10 10 10 10 443 472 453 453 453 453 453 453 453 453 453 453 453 453 453 453 453 453 453 453 453 453 453 453 453 453 453 443 10 10 10 10 10 10 10 10 10 10 10 10 10 10 10 10
10 10 10 10 10 10 10 10 10 10 443 472 453 471 471 453 453 453 453 453 453 453 453 453 453 453 453 453 453 453 453 453 453 453 453 453 453 443 10 10 10 10 10 10 10 10 10 10 10 10 10 10 10 10
10 10 10 10 10 10 10 10 10 10 443 472 453 471 471 453 453 453 453 453 453 453 453 453 453 453 453 453 453 453 453 453 453 453 453 453 453 443 10 10 10 10 10 10 10 10 10 10 10 10 10 10 10 10
10 10 10 10 10 10 10 10 10 10 443 472 453 453 453 453 453 453 453 453 453 453 453 453 453 453 453 453 453 453 453 453 453 453 453 453 453 443 10 10 10 10 10 10 10 10 10 10 10 10 10 10 10 10
10 10 10 10 10 10 10 10 10 10 443 474 475 475 475 475 476 453 453 453 453 453 453 453 453 453 453 453 461 453 461 453 453 453 453 453 453 443 10 10 10 10 10 10 10 10 10 10 10 10 10 10 10 10
10 10 10 10 10 10 10 10 10 10 444 445 445 445 445 445 445 445 445 445 445 445 445 445 445 445 445 445 445 10 445 445 445 445 445 445 445 447 10 10 10 10 10 10 10 10 10 10 10 10 10 10 10 10
10 10 10 10 10 10 10 10 10 10 10 10 10 10 10 10 10 10 10 10 10 10 10 10 10 10 10 10 10 10 10 10 10 10 10 10 10 10 10 10 10 10 10 10 10 10 10 10 10 10 10 10 10 10
10 10 10 10 10 10 10 10 10 10 10 10 10 10 10 10 10 10 10 10 10 10 10 10 10 10 10 10 10 10 10 10 10 10 10 10 10 10 10 10 10 10 10 10 10 10 10 10 10 10 10 10 10 10
