10 10 10 10 10 10 10 10 10 10 10 10 10 10 10 10 10 10 10 10 10 10 10 10 10 10 10 10 10 43 44 57 58 59 59 59 59 59 59 59 59 59 59 59 59 59 59 59 59 41 10 41 10 41
10 10 10 10 10 10 10 10 10 10 10 10 10 10 10 10 10 10 10 10 10 10 10 10 10 10 10 10 10 46 47 57 58 57 57 57 57 57 57 57 57 57 57 57 57 57 57 57 57 10 41 10 41 10
10 10 10 10 10 10 10 10 10 10 10 10 324 325 10 10 10 10 324 325 10 10 10 10 10 10 10 10 10 46 47 57 58 57 42 43 43 43 43 43 43 43 43 43 43 43 43 43 43 41 10 41 10 41
10 10 10 10 10 10 10 10 10 10 10 10 306 317 10 10 10 10 306 317 10 10 10 10 10 10 10 10 10 46 47 57 58 57 45 46 46 46 46 46 46 46 46 46 46 46 46 46 46 10 41 10 41 10
10 10 10 10 10 10 10 10 10 10 10 10 306 317 326 309 309 323 306 317 10 10 10 10 10 10 10 10 10 46 47 57 58 57 45 46 10 41 10 41 60 62 62 62 62 62 62 62 61 41 10 41 10 41
10 10 10 10 10 10 10 10 10 308 309 309 306 317 311 312 312 313 306 317 309 309 310 10 10 10 10 10 10 46 47 57 58 57 45 46 41 10 41 10 63 64 64 64 64 64 86 64 69 10 41 10 41 10
10 10 10 10 10 10 10 10 10 311 312 312 306 317 311 312 312 313 306 317 312 312 313 10 10 10 10 10 10 46 47 57 58 57 45 46 10 41 10 41 66 68 68 68 68 68 68 68 67 41 10 41 10 41
10 10 10 10 10 10 10 10 10 311 312 312 306 317 314 315 315 316 306 317 312 312 313 10 10 10 10 10 10 46 57 57 58 57 45 46 41 10 41 10 72 73 73 73 73 73 73 73 74 10 41 10 41 10
10 10 10 10 10 10 10 10 10 314 315 315 306 307 318 307 318 318 318 317 315 315 316 10 10 10 10 10 10 125 57 57 58 57 45 46 10 41 10 41 72 73 83 73 83 73 83 73 74 41 10 41 10 41
10 10 10 10 10 10 10 10 10 306 318 307 306 307 318 307 318 318 318 317 307 318 317 10 10 10 10 10 10 46 59 57 58 57 45 46 41 10 41 10 72 73 73 73 73 73 73 73 74 10 41 10 41 10
10 10 10 10 10 10 10 10 10 306 318 307 306 307 318 307 318 318 318 317 307 318 317 10 10 10 10 10 10 125 57 57 58 57 45 46 10 41 10 41 75 76 76 186 187 188 76 76 77 41 10 41 10 41
10 10 10 10 10 10 10 10 10 306 318 307 306 307 318 319 320 318 318 317 307 318 317 10 10 10 10 10 10 46 57 57 58 57 45 46 41 10 41 10 189 190 190 190 190 190 190 190 191 10 41 10 41 10
10 10 10 10 10 10 10 10 10 306 318 307 306 307 318 321 322 318 318 317 307 318 317 10 10 10 10 10 10 46 47 57 58 57 45 46 10 41 10 41 72 73 73 73 73 73 73 73 74 41 10 41 10 41
10 10 10 10 10 10 10 10 10 306 318 307 306 307 318 321 322 318 318 317 307 318 317 10 10 10 10 10 10 46 47 57 58 57 45 46 41 10 41 10 78 79 89 79 183 184 184 185 80 10 41 10 41 10
45 46 46 46 46 46 46 46 46 46 46 46 46 46 46 95 95 46 46 46 46 46 46 46 46 46 46 46 46 46 47 57 58 57 45 46 46 46 46 46 95 95 95 95 95 304 303 303 305 46 46 46 46 47
51 126 52 52 52 52 52 52 52 52 52 52 52 52 52 96 96 52 52 52 52 52 52 52 52 52 52 52 52 52 53 57 58 57 51 52 52 52 52 52 96 96 96 96 96 96 96 96 96 52 52 52 52 53
57 57 57 57 57 57 57 57 57 57 57 57 57 57 57 57 57 57 57 57 57 57 57 57 57 57 57 57 57 57 57 57 57 57 57 57 94 57 57 57 57 57 57 57 57 57 57 57 57 57 57 57 57 57
93 93 93 93 93 93 93 93 93 93 93 93 93 93 93 93 93 93 93 93 93 93 93 93 93 93 93 93 93 93 93 93 93 93 93 57 94 57 93 93 93 93 93 93 93 93 93 93 93 93 93 93 93 93
57 57 57 57 57 57 57 57 57 57 57 57 57 57 57 57 57 57 57 57 57 57 57 57 57 57 57 57 57 57 57 57 57 57 57 57 94 57 57 57 57 57 57 57 57 57 57 57 57 57 57 57 57 57
42 43 43 127 43 43 43 43 43 43 43 43 43 43 43 43 43 43 43 43 43 44 57 57 57 42 43 43 43 43 81 43 43 43 43 43 43 43 43 43 43 43 43 43 43 43 43 43 43 43 43 43 43 44
45 46 46 46 46 46 46 46 46 46 46 46 46 46 46 46 46 46 46 46 46 47 90 90 90 45 46 46 46 46 46 46 46 46 46 46 46 46 46 46 46 46 46 46 46 46 46 46 46 46 46 46 46 47
252 252 252 252 252 252 252 252 252 252 252 200 201 201 201 201 201 202 252 252 46 47 57 57 57 45 46 10 41 10 41 10 41 10 41 10 41 10 41 10 41 10 41 10 41 10 41 10 41 10 41 10 41 10
252 219 211 211 211 219 211 211 211 219 252 203 204 204 204 204 204 205 252 252 46 47 57 91 57 45 46 41 10 41 10 41 10 41 10 138 140 140 140 140 140 140 140 140 140 139 10 41 10 41 10 41 10 41
252 213 214 214 214 214 214 214 214 215 252 203 204 204 256 204 204 205 252 252 46 47 57 92 57 45 46 10 41 10 41 10 41 10 41 141 142 142 142 142 142 142 142 142 142 147 41 10 41 10 41 10 41 10
252 213 214 257 214 214 214 214 214 215 253 203 204 204 204 204 204 205 252 252 46 47 57 58 57 45 46 41 10 41 10 41 10 41 10 141 278 142 142 142 142 148 142 148 142 147 10 97 99 99 99 99 99 99
252 213 214 214 214 214 214 214 214 215 252 206 207 207 207 207 207 208 255 252 46 47 57 58 57 45 46 10 41 10 41 10 41 10 41 141 142 142 142 142 142 142 142 142 142 147 41 100 101 277 101 101 101 101
252 219 217 217 217 219 217 217 217 219 252 224 225 225 225 225 225 226 252 252 46 47 57 58 57 45 46 60 62 62 62 62 62 61 10 141 142 142 142 142 142 142 142 142 142 147 10 103 105 105 105 105 105 105
252 236 241 241 241 236 241 241 241 236 252 230 231 231 231 231 231 232 255 252 46 47 57 58 57 45 46 63 64 64 64 64 86 69 41 144 146 146 146 146 146 146 146 146 146 145 41 110 111 111 111 111 111 111
252 237 247 247 247 237 247 247 247 237 254 227 228 228 259 228 228 229 252 252 46 47 57 58 57 45 46 66 68 68 68 68 68 67 10 268 274 269 274 269 274 269 274 269 274 270 10 110 111 111 111 111 111 111
252 237 247 247 247 237 247 247 247 237 252 230 231 231 231 231 231 232 255 252 52 53 57 58 57 51 52 72 73 73 73 73 73 74 41 268 274 269 274 269 274 269 274 269 274 270 41 110 111 111 111 111 111 111
