10 10 10 10 10 10 10 10 10 10 10 10 10 10 10 10 10 10 10 10 43 44 57 58 57 42 43 171 172 172 172 172 172 172 172 172 172 172 172 172 172 172 172 172 172 172 172 172 172 172 172 172 172 173
10 10 10 10 10 10 10 10 10 10 10 10 10 10 10 10 10 10 10 10 46 47 57 58 57 45 46 174 2 2 2 2 2 2 2 2 2 2 2 2 2 2 2 2 2 2 2 2 2 2 2 2 2 176
10 10 10 10 10 10 10 10 10 10 10 10 10 10 10 10 10 10 10 10 46 47 57 58 57 45 46 174 2 2 2 2 2 2 2 2 2 2 2 2 2 2 2 2 2 2 2 2 2 2 2 2 2 176
10 10 10 10 10 10 10 10 10 10 10 10 10 10 10 10 10 10 10 10 46 47 57 58 57 45 46 174 2 2 2 2 2 2 2 2 2 2 2 2 2 2 2 2 2 2 2 2 2 2 2 2 2 176
10 10 10 97 99 99 99 99 99 99 99 99 99 99 99 99 98 10 10 10 46 47 57 58 57 45 46 174 2 2 2 162 163 163 163 163 164 2 2 2 2 2 2 2 162 163 163 163 163 164 2 2 2 176
10 10 10 100 101 109 101 101 101 101 101 101 101 101 101 101 106 10 10 10 46 47 57 58 57 45 46 174 2 2 2 165 12 12 12 12 167 2 2 2 2 2 2 2 165 12 12 12 12 167 2 2 2 176
10 10 10 103 105 105 105 105 105 105 105 105 105 105 105 105 104 10 10 10 46 47 57 58 57 45 46 174 2 2 2 165 12 166 12 12 167 2 2 2 2 2 2 2 165 12 166 12 12 167 2 2 2 176
10 10 10 110 111 111 111 111 111 111 111 111 111 111 111 111 124 10 10 10 46 57 57 58 57 45 46 174 2 2 2 165 12 12 166 12 167 2 296 2 2 2 298 2 165 12 12 166 12 167 2 2 2 176
10 10 10 113 114 120 114 120 114 114 114 114 120 114 120 114 115 10 10 10 125 57 57 58 57 45 46 174 2 2 2 165 12 12 12 12 167 2 297 2 2 2 297 2 165 12 12 12 12 167 2 2 2 176
10 10 10 110 111 111 111 111 111 111 111 111 111 111 111 111 112 10 10 10 46 59 57 58 57 45 46 174 2 2 2 168 169 169 169 169 170 2 2 2 2 2 2 2 168 169 169 169 169 170 2 2 2 176
10 10 10 110 111 111 111 111 111 111 111 111 111 111 111 111 112 10 10 10 125 57 57 58 57 45 46 174 2 2 2 2 2 2 2 2 2 2 2 2 2 2 2 2 2 2 2 2 2 2 2 2 2 176
10 10 10 110 111 111 111 111 111 111 111 111 111 111 111 111 112 10 10 10 46 57 57 58 57 45 46 174 2 2 2 2 2 2 2 2 2 2 2 2 2 2 2 2 2 2 2 2 2 2 2 2 2 176
10 10 10 110 111 111 111 111 111 111 111 111 111 111 111 111 112 10 10 10 46 47 57 58 57 45 46 174 2 2 2 2 2 2 2 2 2 2 2 2 2 2 2 2 2 2 2 2 2 2 2 2 2 176
10 10 10 116 117 117 117 117 117 122 123 117 117 117 117 117 118 10 10 10 46 47 57 58 57 45 46 177 178 178 178 178 178 178 178 178 178 178 178 178 2 178 178 178 178 178 178 178 178 178 178 178 178 179
45 46 46 46 46 46 46 46 46 95 95 46 46 46 46 46 46 46 46 46 46 47 57 58 57 45 46 46 46 46 46 46 46 46 46 46 46 46 302 46 95 46 300 46 46 46 46 46 46 46 46 46 46 47
51 126 52 52 52 52 52 52 52 96 96 52 52 52 52 52 52 52 52 52 52 53 57 58 57 51 52 52 52 52 52 52 52 52 52 52 52 52 301 52 96 52 299 52 52 52 52 52 52 52 52 52 52 53
57 57 57 57 57 57 57 57 57 57 57 57 57 57 57 57 57 57 57 57 94 57 57 57 57 57 57 57 57 57 57 57 57 57 57 57 57 57 57 57 57 57 57 57 57 57 57 57 57 57 57 57 57 57
93 93 93 93 93 93 93 93 93 93 93 93 93 93 93 93 93 93 93 57 94 93 93 93 93 93 93 93 93 93 93 93 93 93 93 93 93 93 93 93 93 93 93 93 93 93 93 93 93 93 93 93 93 93
57 57 57 57 57 57 57 57 57 57 57 57 57 57 57 57 57 57 57 57 94 57 57 57 57 57 57 57 57 57 57 57 57 57 57 57 57 57 57 57 57 57 57 57 57 57 57 57 57 57 57 57 57 57
42 43 43 127 43 43 43 43 43 43 43 43 43 43 43 43 43 43 43 43 43 43 43 57 43 43 43 43 43 43 44 57 57 57 42 43 43 43 43 43 43 43 43 43 43 43 43 43 43 43 43 43 43 44
45 46 46 46 46 46 46 46 46 46 46 46 46 46 46 46 46 46 46 46 46 46 46 57 46 46 46 46 46 46 47 90 90 90 45 46 46 46 46 46 46 46 46 46 46 46 46 46 46 46 46 46 46 47
10 41 10 41 10 41 10 41 10 41 10 41 10 41 10 41 10 41 10 41 10 41 10 10 10 41 10 41 10 46 47 57 57 57 45 46 252 252 252 252 252 252 252 252 252 200 201 201 201 201 201 202 252 252
41 10 41 10 41 10 41 10 41 10 138 140 140 140 140 140 140 140 140 140 139 10 41 10 41 10 41 10 41 46 47 57 91 57 45 46 211 211 211 219 211 211 211 219 252 203 204 204 204 204 204 205 252 252
10 41 10 41 10 41 10 41 10 41 141 142 142 142 142 142 142 142 142 142 147 41 10 41 10 41 10 41 10 46 47 57 92 57 45 46 214 214 214 214 214 214 214 215 252 203 204 204 256 204 204 205 252 252
41 10 41 10 41 10 41 10 41 10 141 278 142 142 142 142 148 142 148 142 147 10 97 99 99 99 99 99 99 46 47 57 58 57 45 46 214 257 214 214 214 214 214 215 253 203 204 204 204 204 204 205 252 252
10 41 10 41 10 41 10 41 10 41 141 142 142 142 142 142 142 142 142 142 147 41 100 101 277 101 101 101 101 46 47 57 58 57 45 46 214 214 214 214 214 214 214 215 252 206 207 207 207 207 207 208 255 252
60 62 60 62 62 62 62 62 61 10 141 142 142 142 142 142 142 142 142 142 147 10 103 105 105 105 105 105 105 46 47 57 58 57 45 46 217 217 217 219 217 217 217 219 252 224 225 225 225 225 225 226 252 252
63 64 63 64 64 64 64 86 69 41 144 146 146 146 146 146 146 146 146 146 145 41 110 111 111 111 111 111 111 46 47 57 58 57 45 46 241 241 241 236 241 241 241 236 252 230 231 231 231 231 231 232 255 252
66 68 66 68 68 68 68 68 67 10 268 274 269 274 269 274 269 274 269 274 270 10 110 111 111 111 111 111 111 46 47 57 58 57 45 46 247 247 247 237 247 247 247 237 254 227 228 228 259 228 228 229 252 252
72 73 72 73 73 73 73 73 74 41 268 274 269 274 269 274 269 274 269 274 270 41 110 111 111 111 111 111 111 52 53 57 58 57 51 52 247 247 247 237 247 247 247 237 252 230 231 231 231 231 231 232 255 252
