10 10 10 10 10 10 10 10 10 10 10 10 10 10 10 10 10 10 10 10 10 10 10 10 10 10 10 10 10 10 10 10 10 10 10 10 10 10 10 10 10 10 10 10 10 10 10 10 10 10 10 10 10 10
10 10 10 10 10 10 10 10 10 10 10 10 10 10 10 10 10 10 10 10 10 10 10 10 10 10 10 10 10 10 10 10 10 10 10 10 10 10 10 10 10 10 10 10 10 10 10 10 10 10 10 10 10 10
10 10 10 10 10 10 10 10 442 445 445 445 445 445 445 445 445 445 445 445 445 445 446 10 10 10 10 10 10 10 442 445 445 445 445 445 445 445 445 445 445 445 445 445 446 10 10 10 10 10 10 10 10 10
10 10 10 10 10 10 10 10 443 454 454 454 454 454 454 454 454 454 454 454 454 454 443 10 10 10 10 10 10 10 443 454 454 454 454 454 454 454 454 454 454 454 454 454 443 10 10 10 10 10 10 10 10 10
10 10 10 10 10 10 10 10 443 454 454 454 454 343 344 344 344 345 454 454 454 454 443 10 10 10 10 10 10 10 443 454 454 454 454 343 344 344 344 345 454 454 454 454 443 10 10 10 10 10 10 10 10 10
10 10 10 10 10 10 10 10 443 454 454 454 454 454 454 454 454 454 454 454 454 454 443 10 10 10 10 10 10 10 443 454 454 454 454 454 454 454 454 454 454 454 454 454 443 10 10 10 10 10 10 10 10 10
10 10 10 10 10 10 10 10 443 451 453 453 453 453 453 453 453 453 453 453 453 453 443 10 10 10 10 10 10 10 443 451 453 453 453 453 453 453 453 453 453 453 453 453 443 10 10 10 10 10 10 10 10 10
10 10 10 10 10 10 10 10 443 451 453 453 453 453 453 346 453 453 453 453 453 453 443 10 10 10 10 10 10 10 443 451 453 453 453 453 453 346 453 453 453 453 453 453 443 10 10 10 10 10 10 10 10 10
10 10 10 10 10 10 10 10 443 451 453 453 453 453 453 471 453 453 453 453 453 453 443 10 10 10 10 10 10 10 443 451 453 453 453 453 453 471 453 453 453 453 453 453 443 10 10 10 10 10 10 10 10 10
10 10 10 10 10 10 10 10 443 451 453 474 475 476 453 453 453 474 475 476 453 453 443 10 10 10 10 10 10 10 443 451 453 474 475 476 453 453 453 474 475 476 453 453 443 10 10 10 10 10 10 10 10 10
10 10 10 10 10 10 10 10 443 451 453 469 469 469 453 453 453 469 469 469 453 453 443 10 10 10 10 10 10 10 443 451 453 469 469 469 453 453 453 469 469 469 453 453 443 10 10 10 10 10 10 10 10 10
10 10 10 10 10 10 10 10 443 451 453 453 453 453 453 453 453 453 453 453 453 453 443 10 10 10 10 10 10 10 443 451 453 453 453 453 453 453 453 453 453 453 453 453 443 10 10 10 10 10 10 10 10 10
10 10 10 10 10 10 10 10 443 451 453 474 475 476 453 453 453 474 475 476 453 453 444 445 445 445 445 445 445 445 447 451 453 474 475 476 453 453 453 474 475 476 453 453 443 10 10 10 10 10 10 10 10 10
10 10 10 10 10 10 10 10 443 451 453 469 469 469 453 453 453 469 469 469 453 453 477 454 454 454 454 454 454 454 477 453 453 469 469 469 453 453 453 469 469 469 453 453 443 10 10 10 10 10 10 10 10 10
10 10 10 10 10 10 10 10 443 451 453 453 453 453 453 453 453 453 453 453 453 453 454 347 454 349 454 349 454 348 454 453 453 453 453 453 453 453 453 453 453 453 453 453 443 10 10 10 10 10 10 10 10 10
10 10 10 10 10 10 10 10 443 451 453 474 475 476 453 453 453 474 475 476 453 453 454 454 454 350 454 350 454 454 454 453 453 474 475 476 453 453 453 474 475 476 453 453 443 10 10 10 10 10 10 10 10 10
10 10 10 10 10 10 10 10 443 451 453 469 469 469 453 453 453 469 469 469 453 453 453 453 453 453 453 453 453 453 453 453 453 469 469 469 453 453 453 469 469 469 453 453 443 10 10 10 10 10 10 10 10 10
10 10 10 10 10 10 10 10 443 451 453 453 453 453 453 453 453 453 453 453 453 453 453 453 453 453 453 453 453 453 453 453 453 453 453 453 453 453 453 453 453 453 453 453 443 10 10 10 10 10 10 10 10 10
10 10 10 10 10 10 10 10 443 451 453 453 453 453 453 453 453 453 453 453 453 453 453 453 453 453 453 453 453 453 453 453 453 453 453 453 453 453 453 453 453 453 453 453 443 10 10 10 10 10 10 10 10 10
10 10 10 10 10 10 10 10 443 451 453 453 453 453 453 453 453 453 453 453 453 453 453 453 453 453 453 453 453 453 453 453 453 453 453 453 453 453 453 453 453 453 453 453 443 10 10 10 10 10 10 10 10 10
10 10 10 10 10 10 10 10 443 451 453 453 453 453 453 453 453 453 453 453 453 453 453 453 453 453 453 453 453 453 453 453 453 453 453 453 453 453 453 453 453 453 453 453 443 10 10 10 10 10 10 10 10 10
10 10 10 10 10 10 10 10 443 451 453 453 453 453 453 453 453 453 453 453 453 453 453 453 453 453 453 453 453 453 453 453 453 453 453 453 453 453 453 453 453 453 453 453 443 10 10 10 10 10 10 10 10 10
10 10 10 10 10 10 10 10 443 451 453 453 453 453 453 453 453 453 453 453 453 453 453 453 453 453 453 453 453 453 453 453 453 453 453 453 453 453 453 453 453 453 453 453 443 10 10 10 10 10 10 10 10 10
10 10 10 10 10 10 10 10 443 451 453 453 453 453 453 453 453 453 453 453 453 453 453 453 453 453 453 453 453 453 453 453 453 453 453 453 453 453 453 453 453 453 453 453 443 10 10 10 10 10 10 10 10 10
10 10 10 10 10 10 10 10 443 451 453 453 453 453 453 453 453 453 453 453 453 453 453 453 453 453 453 453 453 453 453 453 453 453 453 453 453 453 453 453 453 453 453 453 443 10 10 10 10 10 10 10 10 10
10 10 10 10 10 10 10 10 443 451 453 453 453 453 453 453 453 453 453 453 453 453 453 453 453 453 453 453 453 453 453 453 453 453 453 453 453 453 453 453 453 453 453 453 443 10 10 10 10 10 10 10 10 10
10 10 10 10 10 10 10 10 443 474 475 475 475 475 475 475 476 453 453 453 453 453 453 453 453 461 453 461 453 453 453 453 453 453 453 453 474 475 475 475 475 475 475 476 443 10 10 10 10 10 10 10 10 10
10 10 10 10 10 10 10 10 444 445 445 445 445 445 445 445 445 445 445 445 445 445 445 445 445 445 10 445 445 445 445 445 445 445 445 445 445 445 445 445 445 445 445 445 447 10 10 10 10 10 10 10 10 10
10 10 10 10 10 10 10 10 10 10 10 10 10 10 10 10 10 10 10 10 10 10 10 10 10 10 10 10 10 10 10 10 10 10 10 10 10 10 10 10 10 10 10 10 10 10 10 10 10 10 10 10 10 10
10 10 10 10 10 10 10 10 10 10 10 10 10 10 10 10 10 10 10 10 10 10 10 10 10 10 10 10 10 10 10 10 10 10 10 10 10 10 10 10 10 10 10 10 10 10 10 10 10 10 10 10 10 10
